"";"date";"entries";"discharges";"entries_nonICU";"discharges_nonICU";"occupancy_nonICU";"entries_ICU";"discharges_ICU";"occupancy_ICU";"deaths_nonICU";"deaths_ICU";"sum_deaths_nonICU";"sum_deaths_ICU"
"1";2020-03-01;5;0;5;0;5;0;0;0;0;0;0;0
"2";2020-03-02;7;0;7;0;12;0;0;0;0;0;0;0
"3";2020-03-03;12;1;11;1;22;1;0;1;0;0;0;0
"4";2020-03-04;13;0;12;0;34;1;0;2;0;0;0;0
"5";2020-03-05;14;0;8;0;42;6;0;8;0;0;0;0
"6";2020-03-06;13;1;13;1;54;0;0;8;0;0;0;0
"7";2020-03-07;16;0;15;0;69;1;0;9;0;0;0;0
"8";2020-03-08;16;1;15;1;83;1;0;10;0;0;0;0
"9";2020-03-09;18;1;16;1;98;2;0;12;0;0;0;0
"10";2020-03-10;20;0;16;0;114;4;0;16;0;0;0;0
"11";2020-03-11;25;2;20;2;132;5;0;21;0;0;0;0
"12";2020-03-12;23;9;19;9;142;4;0;25;0;0;0;0
"13";2020-03-13;29;11;26;11;157;3;0;28;0;0;0;0
"14";2020-03-14;31;4;25;4;178;6;0;34;0;0;0;0
"15";2020-03-15;26;3;15;3;190;11;0;45;0;0;0;0
"16";2020-03-16;37;7;30;6;214;7;1;51;0;1;0;1
"17";2020-03-17;44;10;33;9;238;11;1;61;1;0;1;1
"18";2020-03-18;53;9;40;8;270;13;1;73;0;1;1;2
"19";2020-03-19;65;14;51;13;308;14;1;86;3;0;4;2
"20";2020-03-20;68;20;49;19;338;19;1;104;4;1;8;3
"21";2020-03-21;95;19;76;19;395;19;0;123;4;0;12;3
"22";2020-03-22;97;12;78;12;461;19;0;142;6;0;18;3
"23";2020-03-23;105;19;85;18;528;20;1;161;5;0;23;3
"24";2020-03-24;119;31;92;26;594;27;5;183;5;5;28;8
"25";2020-03-25;142;31;116;28;682;26;3;206;11;3;39;11
"26";2020-03-26;136;30;113;27;768;23;3;226;6;2;45;13
"27";2020-03-27;145;53;116;45;839;29;8;247;15;5;60;18
"28";2020-03-28;172;41;145;39;945;27;2;272;14;1;74;19
"29";2020-03-29;131;38;109;35;1019;22;3;291;15;2;89;21
"30";2020-03-30;157;72;136;65;1090;21;7;305;23;4;112;25
"31";2020-03-31;170;85;139;80;1149;31;5;331;21;3;133;28
"32";2020-04-01;152;76;137;70;1216;15;6;340;18;3;151;31
"33";2020-04-02;163;92;138;72;1282;25;20;345;21;8;172;39
"34";2020-04-03;129;97;109;84;1307;20;13;352;13;3;185;42
"35";2020-04-04;134;66;115;60;1362;19;6;365;24;4;209;46
"36";2020-04-05;127;60;118;51;1429;9;9;365;16;5;225;51
"37";2020-04-06;125;110;113;98;1444;12;12;365;24;3;249;54
"38";2020-04-07;114;137;105;124;1425;9;13;361;28;5;277;59
"39";2020-04-08;122;120;111;112;1424;11;8;364;19;3;296;62
"40";2020-04-09;88;97;77;86;1415;11;11;364;22;3;318;65
"41";2020-04-10;107;102;94;93;1416;13;9;368;32;1;350;66
"42";2020-04-11;102;70;92;60;1448;10;10;368;23;1;373;67
"43";2020-04-12;90;58;79;49;1478;11;9;370;24;6;397;73
"44";2020-04-13;90;109;80;96;1462;10;13;367;25;5;422;78
"45";2020-04-14;116;128;107;113;1456;9;15;361;28;4;450;82
"46";2020-04-15;103;125;96;110;1442;7;15;353;26;2;476;84
"47";2020-04-16;94;111;87;97;1432;7;14;346;23;5;499;89
"48";2020-04-17;106;129;94;113;1413;12;16;342;24;7;523;96
"49";2020-04-18;75;72;67;60;1420;8;12;338;23;4;546;100
"50";2020-04-19;55;66;51;59;1412;4;7;335;19;2;565;102
"51";2020-04-20;80;113;73;96;1389;7;17;325;25;2;590;104
"52";2020-04-21;61;99;55;92;1352;6;7;324;20;3;610;107
"53";2020-04-22;58;105;52;89;1315;6;16;314;21;3;631;110
"54";2020-04-23;62;98;55;86;1284;7;12;309;9;3;640;113
"55";2020-04-24;67;110;57;93;1248;10;17;302;21;4;661;117
"56";2020-04-25;61;55;53;49;1252;8;6;304;17;1;678;118
"57";2020-04-26;47;52;45;46;1251;2;6;300;18;2;696;120
"58";2020-04-27;42;93;38;83;1206;4;10;294;12;4;708;124
"59";2020-04-28;38;99;36;83;1159;2;16;280;14;5;722;129
"60";2020-04-29;45;85;42;76;1125;3;9;274;9;1;731;130
"61";2020-04-30;52;85;45;79;1091;7;6;275;17;1;748;131
"62";2020-05-01;40;60;36;51;1076;4;9;270;11;0;759;131
"63";2020-05-02;40;52;36;45;1067;4;7;267;10;5;769;136
"64";2020-05-03;34;40;33;40;1060;1;0;268;17;0;786;136
"65";2020-05-04;49;104;41;91;1010;8;13;263;9;2;795;138
"66";2020-05-05;33;106;27;91;946;6;15;254;10;1;805;139
"67";2020-05-06;41;86;39;69;916;2;17;239;10;0;815;139
"68";2020-05-07;52;66;51;61;906;1;5;235;10;0;825;139
"69";2020-05-08;29;88;25;68;863;4;20;219;7;3;832;142
"70";2020-05-09;39;40;33;34;862;6;6;219;5;2;837;144
"71";2020-05-10;34;26;30;22;870;4;4;219;9;3;846;147
"72";2020-05-11;34;83;25;75;820;9;8;220;9;1;855;148
"73";2020-05-12;38;67;35;56;799;3;11;212;7;2;862;150
"74";2020-05-13;50;81;41;70;770;9;11;210;2;2;864;152
"75";2020-05-14;49;73;46;60;756;3;13;200;4;2;868;154
"76";2020-05-15;48;56;44;50;750;4;6;198;3;0;871;154
"77";2020-05-16;37;38;31;34;747;6;4;200;9;2;880;156
"78";2020-05-17;33;22;30;21;756;3;1;202;8;1;888;157
"79";2020-05-18;25;74;24;66;714;1;8;195;3;3;891;160
"80";2020-05-19;31;65;27;55;686;4;10;189;9;1;900;161
"81";2020-05-20;44;72;39;62;663;5;10;184;7;0;907;161
"82";2020-05-21;21;42;20;35;648;1;7;178;3;1;910;162
"83";2020-05-22;36;83;34;70;612;2;13;167;1;3;911;165
"84";2020-05-23;37;35;31;30;613;6;5;168;7;2;918;167
"85";2020-05-24;34;15;28;12;629;6;3;171;3;2;921;169
"86";2020-05-25;33;57;30;46;613;3;11;163;2;1;923;170
"87";2020-05-26;39;46;37;37;613;2;9;156;5;2;928;172
"88";2020-05-27;66;66;61;62;612;5;4;157;7;0;935;172
"89";2020-05-28;55;60;49;55;606;6;5;158;6;2;941;174
"90";2020-05-29;38;73;36;65;577;2;8;152;9;1;950;175
"91";2020-05-30;33;25;30;25;582;3;0;155;5;0;955;175
"92";2020-05-31;16;18;14;18;578;2;0;157;5;0;960;175
"93";2020-06-01;49;54;41;47;572;8;7;158;9;2;969;177
"94";2020-06-02;40;45;36;40;568;4;5;157;1;0;970;177
"95";2020-06-03;42;51;38;44;562;4;7;154;4;2;974;179
"96";2020-06-04;40;56;38;49;551;2;7;149;5;0;979;179
"97";2020-06-05;35;65;31;56;526;4;9;144;11;1;990;180
"98";2020-06-06;27;32;26;30;522;1;2;143;3;1;993;181
"99";2020-06-07;28;18;21;17;526;7;1;149;4;0;997;181
"100";2020-06-08;35;43;29;39;516;6;4;151;4;0;1001;181
"101";2020-06-09;37;45;33;43;506;4;2;153;4;0;1005;181
"102";2020-06-10;26;31;25;26;505;1;5;149;7;1;1012;182
"103";2020-06-11;35;7;29;7;527;6;0;155;0;0;1012;182
"104";2020-06-12;40;64;36;58;505;4;6;153;3;5;1015;187
"105";2020-06-13;39;22;35;20;520;4;2;155;2;2;1017;189
"106";2020-06-14;23;16;21;15;526;2;1;156;0;0;1017;189
"107";2020-06-15;51;63;43;50;519;8;13;151;6;1;1023;190
"108";2020-06-16;29;41;26;38;507;3;3;151;2;1;1025;191
"109";2020-06-17;36;57;31;45;493;5;12;144;5;2;1030;193
"110";2020-06-18;46;46;42;40;495;4;6;142;7;1;1037;194
"111";2020-06-19;46;62;42;51;486;4;11;135;1;0;1038;194
"112";2020-06-20;47;23;41;19;508;6;4;137;5;1;1043;195
"113";2020-06-21;39;9;34;8;534;5;1;141;3;1;1046;196
"114";2020-06-22;53;64;48;53;529;5;11;135;3;3;1049;199
"115";2020-06-23;53;53;47;46;530;6;7;134;3;1;1052;200
"116";2020-06-24;53;42;45;39;536;8;3;139;5;2;1057;202
"117";2020-06-25;46;51;39;47;528;7;4;142;5;1;1062;203
"118";2020-06-26;45;52;38;45;521;7;7;142;3;3;1065;206
"119";2020-06-27;38;25;35;23;533;3;2;143;6;0;1071;206
"120";2020-06-28;37;13;31;12;552;6;1;148;4;0;1075;206
"121";2020-06-29;37;62;29;54;527;8;8;148;7;2;1082;208
"122";2020-06-30;31;36;27;32;522;4;4;148;5;0;1087;208
"123";2020-07-01;39;59;34;50;506;5;9;144;5;3;1092;211
"124";2020-07-02;33;46;31;42;495;2;4;142;7;4;1099;215
"125";2020-07-03;51;65;45;61;479;6;4;144;8;1;1107;216
"126";2020-07-04;37;23;33;18;494;4;5;143;7;1;1114;217
"127";2020-07-05;37;22;31;19;506;6;3;146;5;2;1119;219
"128";2020-07-06;44;59;39;54;491;5;5;146;7;1;1126;220
"129";2020-07-07;39;37;35;31;495;4;6;144;5;3;1131;223
"130";2020-07-08;40;58;37;48;484;3;10;137;11;2;1142;225
"131";2020-07-09;35;52;32;46;470;3;6;134;3;0;1145;225
"132";2020-07-10;40;45;34;38;466;6;7;133;7;2;1152;227
"133";2020-07-11;23;25;23;18;471;0;7;126;5;5;1157;232
"134";2020-07-12;25;8;21;8;484;4;0;130;1;0;1158;232
"135";2020-07-13;36;38;32;29;487;4;9;125;4;2;1162;234
"136";2020-07-14;30;42;29;39;477;1;3;123;6;0;1168;234
"137";2020-07-15;36;39;30;34;473;6;5;124;4;0;1172;234
"138";2020-07-16;29;37;25;31;467;4;6;122;3;0;1175;234
"139";2020-07-17;30;51;24;42;449;6;9;119;3;0;1178;234
"140";2020-07-18;26;20;24;17;456;2;3;118;5;1;1183;235
"141";2020-07-19;28;13;24;12;468;4;1;121;4;1;1187;236
"142";2020-07-20;32;44;27;39;456;5;5;121;4;3;1191;239
"143";2020-07-21;29;39;27;31;452;2;8;115;5;2;1196;241
"144";2020-07-22;27;33;25;30;447;2;3;114;3;1;1199;242
"145";2020-07-23;33;52;29;43;433;4;9;109;5;2;1204;244
"146";2020-07-24;32;47;28;39;422;4;8;105;3;0;1207;244
"147";2020-07-25;24;18;20;16;426;4;2;107;3;0;1210;244
"148";2020-07-26;28;12;28;10;444;0;2;105;2;1;1212;245
"149";2020-07-27;19;34;18;32;430;1;2;104;2;0;1214;245
"150";2020-07-28;23;30;19;26;423;4;4;104;2;1;1216;246
"151";2020-07-29;22;35;19;30;412;3;5;102;4;0;1220;246
"152";2020-07-30;21;42;18;36;394;3;6;99;5;3;1225;249
"153";2020-07-31;20;58;18;45;367;2;13;88;1;1;1226;250
"154";2020-08-01;22;9;18;9;376;4;0;92;1;0;1227;250
"155";2020-08-02;22;6;21;4;393;1;2;91;1;2;1228;252
"156";2020-08-03;15;28;12;24;381;3;4;90;1;0;1229;252
"157";2020-08-04;16;29;13;26;368;3;3;90;3;0;1232;252
"158";2020-08-05;20;27;18;23;363;2;4;88;4;0;1236;252
"159";2020-08-06;21;32;19;27;355;2;5;85;6;1;1242;253
"160";2020-08-07;43;49;42;41;356;1;8;78;1;3;1243;256
"161";2020-08-08;23;16;21;15;362;2;1;79;4;1;1247;257
"162";2020-08-09;24;12;21;10;373;3;2;80;4;1;1251;258
"163";2020-08-10;29;37;24;36;361;5;1;84;2;0;1253;258
"164";2020-08-11;29;19;25;17;369;4;2;86;3;0;1256;258
"165";2020-08-12;16;25;15;20;364;1;5;82;4;0;1260;258
"166";2020-08-13;13;27;9;22;351;4;5;81;5;0;1265;258
"167";2020-08-14;18;27;15;24;342;3;3;81;3;0;1268;258
"168";2020-08-15;25;13;18;12;348;7;1;87;4;1;1272;259
"169";2020-08-16;20;6;18;6;360;2;0;89;2;0;1274;259
"170";2020-08-17;27;33;22;25;357;5;8;86;4;2;1278;261
"171";2020-08-18;20;28;20;26;351;0;2;84;1;1;1279;262
"172";2020-08-19;29;29;21;25;347;8;4;88;4;0;1283;262
"173";2020-08-20;25;32;22;30;339;3;2;89;2;1;1285;263
"174";2020-08-21;22;14;19;12;346;3;2;90;2;0;1287;263
"175";2020-08-22;20;12;18;11;353;2;1;91;4;0;1291;263
"176";2020-08-23;25;17;18;14;357;7;3;95;4;2;1295;265
"177";2020-08-24;23;24;20;19;358;3;5;93;3;2;1298;267
"178";2020-08-25;25;34;21;30;349;4;4;93;8;0;1306;267
"179";2020-08-26;31;37;27;35;341;4;2;95;2;0;1308;267
"180";2020-08-27;36;25;28;19;350;8;6;97;4;1;1312;268
"181";2020-08-28;32;42;27;35;342;5;7;95;1;0;1313;268
"182";2020-08-29;30;12;26;12;356;4;0;99;3;0;1316;268
"183";2020-08-30;23;12;20;12;364;3;0;102;4;0;1320;268
"184";2020-08-31;29;30;24;25;363;5;5;102;2;0;1322;268
"185";2020-09-01;34;23;32;16;379;2;7;97;2;2;1324;270
"186";2020-09-02;44;29;35;25;389;9;4;102;1;1;1325;271
"187";2020-09-03;47;38;39;36;392;8;2;108;4;1;1329;272
"188";2020-09-04;37;29;30;25;397;7;4;111;4;1;1333;273
"189";2020-09-05;43;16;39;15;421;4;1;114;3;0;1336;273
"190";2020-09-06;38;10;28;9;440;10;1;123;3;1;1339;274
"191";2020-09-07;47;37;46;31;455;1;6;118;4;0;1343;274
"192";2020-09-08;46;38;35;30;460;11;8;121;2;0;1345;274
"193";2020-09-09;50;24;44;24;480;6;0;127;3;0;1348;274
"194";2020-09-10;49;35;42;31;491;7;4;130;6;2;1354;276
"195";2020-09-11;53;33;48;29;510;5;4;131;4;0;1358;276
"196";2020-09-12;46;24;39;23;526;7;1;137;5;1;1363;277
"197";2020-09-13;49;11;41;10;557;8;1;144;4;1;1367;278
"198";2020-09-14;49;45;39;38;558;10;7;147;2;2;1369;280
"199";2020-09-15;51;42;42;37;563;9;5;151;4;1;1373;281
"200";2020-09-16;51;54;49;46;566;2;8;145;9;2;1382;283
"201";2020-09-17;49;44;42;41;567;7;3;149;5;1;1387;284
"202";2020-09-18;62;48;55;43;579;7;5;151;3;2;1390;286
"203";2020-09-19;55;31;49;27;601;6;4;153;10;2;1400;288
"204";2020-09-20;49;19;41;15;627;8;4;157;3;3;1403;291
"205";2020-09-21;67;47;62;41;648;5;6;156;6;1;1409;292
"206";2020-09-22;68;53;58;47;659;10;6;160;4;0;1413;292
"207";2020-09-23;76;44;64;41;682;12;3;169;5;1;1418;293
"208";2020-09-24;71;36;59;34;707;12;2;179;6;0;1424;293
"209";2020-09-25;60;70;51;63;695;9;7;181;7;1;1431;294
"210";2020-09-26;52;26;44;25;714;8;1;188;6;0;1437;294
"211";2020-09-27;65;21;53;17;750;12;4;196;4;1;1441;295
"212";2020-09-28;54;42;46;37;759;8;5;199;7;1;1448;296
"213";2020-09-29;65;65;51;57;753;14;8;205;10;1;1458;297
"214";2020-09-30;69;50;60;46;767;9;4;210;4;0;1462;297
"215";2020-10-01;68;59;58;50;775;10;9;211;6;2;1468;299
"216";2020-10-02;64;65;53;58;770;11;7;215;13;2;1481;301
"217";2020-10-03;65;43;61;39;792;4;4;215;13;2;1494;303
"218";2020-10-04;76;32;69;30;831;7;2;220;7;1;1501;304
"219";2020-10-05;91;37;78;28;881;13;9;224;10;5;1511;309
"220";2020-10-06;96;52;81;46;916;15;6;233;7;3;1518;312
"221";2020-10-07;113;78;97;71;942;16;7;242;7;2;1525;314
"222";2020-10-08;84;77;73;69;946;11;8;245;11;1;1536;315
"223";2020-10-09;122;91;110;79;977;12;12;245;3;5;1539;320
"224";2020-10-10;87;31;79;25;1031;8;6;247;11;2;1550;322
"225";2020-10-11;74;31;57;25;1063;17;6;258;12;2;1562;324
"226";2020-10-12;98;86;81;73;1071;17;13;262;16;3;1578;327
"227";2020-10-13;105;80;95;74;1092;10;6;266;7;0;1585;327
"228";2020-10-14;129;109;112;93;1111;17;16;267;12;1;1597;328
"229";2020-10-15;127;125;109;110;1110;18;15;270;23;3;1620;331
"230";2020-10-16;132;101;115;88;1137;17;13;274;12;6;1632;337
"231";2020-10-17;131;46;110;41;1206;21;5;290;17;2;1649;339
"232";2020-10-18;139;37;118;33;1291;21;4;307;15;2;1664;341
"233";2020-10-19;156;123;128;111;1308;28;12;323;14;4;1678;345
"234";2020-10-20;183;114;160;103;1365;23;11;335;14;1;1692;346
"235";2020-10-21;174;114;148;102;1411;26;12;349;13;4;1705;350
"236";2020-10-22;189;138;166;119;1458;23;19;353;31;4;1736;354
"237";2020-10-23;203;144;185;122;1521;18;22;349;18;6;1754;360
"238";2020-10-24;184;72;155;65;1611;29;7;371;22;2;1776;362
"239";2020-10-25;151;57;135;52;1694;16;5;382;26;4;1802;366
"240";2020-10-26;240;165;206;152;1748;34;13;403;19;4;1821;370
"241";2020-10-27;198;175;176;154;1770;22;21;404;22;5;1843;375
"242";2020-10-28;208;172;176;156;1790;32;16;420;28;4;1871;379
"243";2020-10-29;222;182;192;164;1818;30;18;432;39;5;1910;384
"244";2020-10-30;260;211;228;196;1850;32;15;449;32;4;1942;388
"245";2020-10-31;249;94;221;83;1988;28;11;466;29;4;1971;392
"246";2020-11-01;240;82;199;69;2118;41;13;494;37;9;2008;401
"247";2020-11-02;226;200;198;184;2132;28;16;506;37;3;2045;404
"248";2020-11-03;234;250;212;216;2128;22;34;494;46;7;2091;411
"249";2020-11-04;310;251;278;235;2171;32;16;510;39;3;2130;414
"250";2020-11-05;330;258;289;230;2230;41;28;523;36;10;2166;424
"251";2020-11-06;262;250;232;228;2234;30;22;531;43;5;2209;429
"252";2020-11-07;281;102;244;96;2382;37;6;562;38;5;2247;434
"253";2020-11-08;251;112;216;101;2497;35;11;586;44;7;2291;441
"254";2020-11-09;272;256;252;224;2525;20;32;574;37;16;2328;457
"255";2020-11-10;262;277;234;249;2510;28;28;574;54;8;2382;465
"256";2020-11-11;344;283;313;254;2569;31;29;576;56;9;2438;474
"257";2020-11-12;299;287;265;258;2576;34;29;581;47;12;2485;486
"258";2020-11-13;293;284;263;260;2579;30;24;587;43;1;2528;487
"259";2020-11-14;318;127;286;104;2761;32;23;596;48;14;2576;501
"260";2020-11-15;262;155;223;139;2845;39;16;619;66;11;2642;512
"261";2020-11-16;292;310;260;289;2816;32;21;630;54;6;2696;518
"262";2020-11-17;289;331;262;298;2780;27;33;624;60;10;2756;528
"263";2020-11-18;319;303;270;280;2770;49;23;650;59;6;2815;534
"264";2020-11-19;324;276;291;248;2813;33;28;655;36;8;2851;542
"265";2020-11-20;337;349;303;319;2797;34;30;659;52;5;2903;547
"266";2020-11-21;289;125;271;112;2956;18;13;664;49;6;2952;553
"267";2020-11-22;306;144;254;126;3084;52;18;698;59;9;3011;562
"268";2020-11-23;289;323;261;297;3048;28;26;700;64;5;3075;567
"269";2020-11-24;308;314;279;287;3040;29;27;702;49;11;3124;578
"270";2020-11-25;320;313;281;283;3038;39;30;711;53;14;3177;592
"271";2020-11-26;318;288;285;265;3058;33;23;721;44;8;3221;600
"272";2020-11-27;302;387;266;341;2983;36;46;711;53;14;3274;614
"273";2020-11-28;310;133;273;119;3137;37;14;734;41;9;3315;623
"274";2020-11-29;250;138;228;119;3246;22;19;737;55;12;3370;635
"275";2020-11-30;278;363;252;326;3172;26;37;726;51;11;3421;646
"276";2020-12-01;293;156;256;146;3282;37;10;753;61;5;3482;651
"277";2020-12-02;290;349;262;312;3232;28;37;744;52;10;3534;661
"278";2020-12-03;273;366;246;321;3157;27;45;726;48;5;3582;666
"279";2020-12-04;334;372;301;339;3119;33;33;726;55;11;3637;677
"280";2020-12-05;259;168;231;152;3198;28;16;738;60;8;3697;685
"281";2020-12-06;255;148;235;132;3301;20;16;742;61;12;3758;697
"282";2020-12-07;268;397;249;347;3203;19;50;711;55;8;3813;705
"283";2020-12-08;266;168;234;151;3286;32;17;726;59;10;3872;715
"284";2020-12-09;281;394;254;356;3184;27;38;715;67;7;3939;722
"285";2020-12-10;236;356;209;323;3070;27;33;709;78;7;4017;729
"286";2020-12-11;257;403;234;353;2951;23;50;682;55;14;4072;743
"287";2020-12-12;249;166;231;150;3032;18;16;684;77;11;4149;754
"288";2020-12-13;251;134;227;120;3139;24;14;694;64;10;4213;764
"289";2020-12-14;249;321;224;286;3077;25;35;684;60;12;4273;776
"290";2020-12-15;273;320;244;288;3033;29;32;681;57;11;4330;787
"291";2020-12-16;272;317;248;282;2999;24;35;670;59;10;4389;797
"292";2020-12-17;226;287;200;255;2944;26;32;664;51;11;4440;808
"293";2020-12-18;268;339;241;308;2877;27;31;660;58;6;4498;814
"294";2020-12-19;214;154;197;138;2936;17;16;661;58;10;4556;824
"295";2020-12-20;261;101;232;87;3081;29;14;676;43;5;4599;829
"296";2020-12-21;226;356;196;317;2960;30;39;667;48;8;4647;837
"297";2020-12-22;294;372;264;336;2888;30;36;661;58;12;4705;849
"298";2020-12-23;297;373;279;334;2833;18;39;640;48;6;4753;855
"299";2020-12-24;232;294;199;267;2765;33;27;646;50;6;4803;861
"300";2020-12-25;221;111;203;101;2867;18;10;654;49;8;4852;869
"301";2020-12-26;264;117;231;101;2997;33;16;671;49;10;4901;879
"302";2020-12-27;250;109;228;95;3130;22;14;679;46;12;4947;891
"303";2020-12-28;277;295;250;262;3118;27;33;673;44;17;4991;908
"304";2020-12-29;337;323;306;304;3120;31;19;685;51;5;5042;913
"305";2020-12-30;291;332;271;293;3098;20;39;666;49;17;5091;930
"306";2020-12-31;362;366;325;324;3099;37;42;661;42;12;5133;942
"307";2021-01-01;302;145;280;133;3246;22;12;671;50;11;5183;953
"308";2021-01-02;299;138;272;122;3396;27;16;682;53;13;5236;966
"309";2021-01-03;343;118;307;102;3601;36;16;702;44;13;5280;979
"310";2021-01-04;335;312;294;280;3615;41;32;711;58;12;5338;991
"311";2021-01-05;369;335;324;295;3644;45;40;716;61;11;5399;1002
"312";2021-01-06;389;331;354;293;3705;35;38;713;67;10;5466;1012
"313";2021-01-07;409;351;354;318;3741;55;33;735;73;12;5539;1024
"314";2021-01-08;473;390;418;349;3810;55;41;749;72;10;5611;1034
"315";2021-01-09;431;166;378;149;4039;53;17;785;74;12;5685;1046
"316";2021-01-10;389;167;350;149;4240;39;18;806;79;13;5764;1059
"317";2021-01-11;404;399;356;352;4244;48;47;807;92;18;5856;1077
"318";2021-01-12;496;414;450;374;4320;46;40;813;96;15;5952;1092
"319";2021-01-13;472;398;424;352;4392;48;46;815;89;24;6041;1116
"320";2021-01-14;502;417;461;367;4486;41;50;806;94;16;6135;1132
"321";2021-01-15;483;494;445;452;4479;38;42;802;110;11;6245;1143
"322";2021-01-16;476;265;416;242;4653;60;23;839;83;14;6328;1157
"323";2021-01-17;457;224;415;206;4862;42;18;863;93;9;6421;1166
"324";2021-01-18;470;467;424;426;4860;46;41;868;112;18;6533;1184
"325";2021-01-19;557;559;507;513;4854;50;46;872;122;19;6655;1203
"326";2021-01-20;554;478;506;438;4922;48;40;880;116;15;6771;1218
"327";2021-01-21;545;461;506;428;5000;39;33;886;124;12;6895;1230
"328";2021-01-22;560;579;503;534;4969;57;45;898;164;19;7059;1249
"329";2021-01-23;549;360;507;319;5157;42;41;899;146;19;7205;1268
"330";2021-01-24;488;279;444;254;5347;44;25;918;136;19;7341;1287
"331";2021-01-25;596;565;543;518;5372;53;47;924;142;17;7483;1304
"332";2021-01-26;626;664;574;606;5340;52;58;918;159;26;7642;1330
"333";2021-01-27;565;653;507;600;5247;58;53;923;160;16;7802;1346
"334";2021-01-28;590;596;530;549;5228;60;47;936;141;12;7943;1358
"335";2021-01-29;539;647;492;588;5132;47;59;924;148;17;8091;1375
"336";2021-01-30;542;397;499;372;5259;43;25;942;162;17;8253;1392
"337";2021-01-31;499;319;454;290;5423;45;29;958;168;16;8421;1408
"338";2021-02-01;489;635;441;591;5273;48;44;962;149;17;8570;1425
"339";2021-02-02;531;615;496;577;5192;35;38;959;125;17;8695;1442
"340";2021-02-03;515;678;468;630;5030;47;48;958;126;20;8821;1462
"341";2021-02-04;478;599;440;561;4909;38;38;958;154;13;8975;1475
"342";2021-02-05;425;697;393;636;4666;32;61;929;127;20;9102;1495
"343";2021-02-06;387;294;346;276;4736;41;18;952;122;10;9224;1505
"344";2021-02-07;310;257;279;231;4784;31;26;957;115;13;9339;1518
"345";2021-02-08;320;598;293;555;4522;27;43;941;116;15;9455;1533
"346";2021-02-09;354;579;327;532;4317;27;47;921;99;15;9554;1548
"347";2021-02-10;352;568;301;508;4110;51;60;912;120;22;9674;1570
"348";2021-02-11;272;523;246;481;3875;26;42;896;104;14;9778;1584
"349";2021-02-12;272;611;244;543;3576;28;68;856;93;24;9871;1608
"350";2021-02-13;227;221;210;193;3593;17;28;845;78;19;9949;1627
"351";2021-02-14;175;165;155;144;3604;20;21;844;62;12;10011;1639
"352";2021-02-15;181;474;154;423;3335;27;51;820;73;16;10084;1655
"353";2021-02-16;181;458;165;405;3095;16;53;783;92;11;10176;1666
"354";2021-02-17;167;416;152;370;2877;15;46;752;66;19;10242;1685
"355";2021-02-18;151;352;138;314;2701;13;38;727;51;7;10293;1692
"356";2021-02-19;170;451;150;406;2445;20;45;702;51;5;10344;1697
"357";2021-02-20;144;120;128;104;2469;16;16;702;44;10;10388;1707
"358";2021-02-21;97;110;86;94;2461;11;16;697;47;8;10435;1715
"359";2021-02-22;121;348;109;314;2256;12;34;675;40;4;10475;1719
"360";2021-02-23;105;297;91;257;2090;14;40;649;36;9;10511;1728
"361";2021-02-24;104;262;96;226;1960;8;36;621;28;8;10539;1736
"362";2021-02-25;101;265;94;224;1830;7;41;587;33;14;10572;1750
"363";2021-02-26;80;280;66;237;1659;14;43;558;24;11;10596;1761
"364";2021-02-27;83;96;72;82;1649;11;14;555;21;9;10617;1770
"365";2021-02-28;57;60;51;50;1650;6;10;551;25;5;10642;1775
"366";2021-03-01;86;244;80;203;1527;6;41;516;23;11;10665;1786
"367";2021-03-02;70;200;58;172;1413;12;28;500;30;5;10695;1791
"368";2021-03-03;71;181;63;156;1320;8;25;483;22;4;10717;1795
"369";2021-03-04;67;176;57;153;1224;10;23;470;24;5;10741;1800
"370";2021-03-05;68;209;64;180;1108;4;29;445;18;5;10759;1805
"371";2021-03-06;60;53;55;45;1118;5;8;442;19;6;10778;1811
"372";2021-03-07;38;41;35;32;1121;3;9;436;17;5;10795;1816
"373";2021-03-08;45;184;40;155;1006;5;29;412;17;11;10812;1827
"374";2021-03-09;52;149;43;123;926;9;26;395;13;6;10825;1833
"375";2021-03-10;50;127;47;109;864;3;18;380;12;3;10837;1836
"376";2021-03-11;41;112;35;91;808;6;21;365;10;4;10847;1840
"377";2021-03-12;33;132;28;111;725;5;21;349;16;3;10863;1843
"378";2021-03-13;33;39;30;32;723;3;7;345;7;7;10870;1850
"379";2021-03-14;27;27;25;22;726;2;5;342;11;4;10881;1854
"380";2021-03-15;29;95;28;71;683;1;24;319;6;6;10887;1860
"381";2021-03-16;38;111;33;89;627;5;22;302;9;5;10896;1865
"382";2021-03-17;41;82;35;65;597;6;17;291;6;7;10902;1872
"383";2021-03-18;39;79;37;59;575;2;20;273;6;3;10908;1875
"384";2021-03-19;35;100;31;73;533;4;27;250;8;5;10916;1880
"385";2021-03-20;24;18;22;11;544;2;7;245;3;3;10919;1883
"386";2021-03-21;28;24;24;18;550;4;6;243;6;5;10925;1888
"387";2021-03-22;40;76;36;65;521;4;11;236;5;1;10930;1889
"388";2021-03-23;37;79;32;57;496;5;22;219;6;7;10936;1896
"389";2021-03-24;34;63;31;56;471;3;7;215;5;2;10941;1898
"390";2021-03-25;34;60;29;51;449;5;9;211;5;0;10946;1898
"391";2021-03-26;32;80;28;62;415;4;18;197;3;3;10949;1901
"392";2021-03-27;25;25;22;20;417;3;5;195;4;4;10953;1905
"393";2021-03-28;13;21;10;18;409;3;3;195;5;2;10958;1907
"394";2021-03-29;22;63;20;56;373;2;7;190;2;1;10960;1908
"395";2021-03-30;25;50;23;35;361;2;15;177;4;1;10964;1909
"396";2021-03-31;34;61;32;48;345;2;13;166;8;3;10972;1912
